miaule - chat + chien = aboie (Expected: aboie)
nage - poisson + oiseau = 4Ã200 (Expected: vol)
bourdonne - abeille + serpent = tordra (Expected: siffle)
hennit - cheval + vache = meugle (Expected: meugle)
cancane - canard + coq = serrÃ©category (Expected: chante)
coasse - grenouille + hibou = galurin (Expected: hulule)
froid - glace + feu = feu. (Expected: chaud)
brule - feu + eau = assechement (Expected: mouille)
souffle - vent + pluie = prÃ©lassement (Expected: tombe)
reine - roi + homme = femme (Expected: femme)
insecte - sauterelle + lion = slaad (Expected: animal)
carnivore - lion + giraffe = herbivore (Expected: herbivore)
jour - soleil + lune = 920103 (Expected: nuit)
joie - rire + pleur = rÃ©flexion1 (Expected: tristesse)
minute - heure + minute = last (Expected: seconde)
fruit - poire + carotte = courge-spaghetti (Expected: légume)
sportif - sport + art = contemporain (Expected: artiste)
guitariste - guitare + trompette = flutiste (Expected: trompettiste)
pianiste - piano + guitare = guitariste (Expected: guitariste)
couleur - bleu + mille = francs? (Expected: chiffre)
nid - oiseau + lapin = lapinou (Expected: terrier)
couleur - rouge + dix = vingt-cinq (Expected: nombre)
vache - lait + miel = becfigue (Expected: abeille)
route - voiture + bateau = pagayant (Expected: mer)
temps - montre + boussole = spÃ©rique (Expected: direction)
satellite - lune + terre = satÃ©llite (Expected: planète)
meute - loup + poisson = poissons (Expected: banc)
pied - chaussette + gant = centre (Expected: main)
miaulement - chat + chien = grognement (Expected: aboiement)
mer - bateau + avion = valujet (Expected: ciel)
poisson - saumon + cerf = cornu (Expected: animal)
oiseau - merle + brochet = esturgeon (Expected: poisson)
fruit - pomme + laitue = tomatillos (Expected: légume)
acide - citron + lait = urÃ©e (Expected: doux)
chaud - soleil + neige = froid (Expected: froide)
chauffage - froid + chaud = eau-chaude (Expected: climatisation)
fleu - rose + baobab = kapokier (Expected: arbre)
roue - voiture + avion = llrv (Expected: aile)
fruit - ananas + courgette = courge-spaghetti (Expected: légume)
