chat - miaule + chien = chiens-online (Expected: aboie)
poisson - nage + oiseau = lapin (Expected: vol)
abeille - bourdonne + serpent = sonette (Expected: siffle)
cheval - hennit + vache = terresoyez (Expected: meugle)
canard - cancane + coq = pÃªchecategory (Expected: chante)
grenouille - coasse + hibou = girafe (Expected: hulule)
glace - froid + feu = chaud (Expected: chaud)
feu - brule + eau = froide.dans (Expected: mouille)
vent - souffle + pluie = neige (Expected: tombe)
roi - reine + homme = femme (Expected: femme)
sauterelle - insecte + lion = lÃ©opardÃ©e (Expected: animal)
lion - carnivore + giraffe = ashiana (Expected: herbivore)
soleil - jour + lune = nuages (Expected: nuit)
rire - joie + pleur = pleurer (Expected: tristesse)
heure - minute + minute = divisionclubrÃ©sultatclubdivisionlieudate (Expected: seconde)
poire - fruit + carotte = compote (Expected: légume)
sport - sportif + art = mail-art. (Expected: artiste)
guitare - guitariste + trompette = flÃ»te (Expected: trompettiste)
piano - pianiste + guitare = clarinette (Expected: guitariste)
bleu - couleur + mille = cents (Expected: chiffre)
oiseau - nid + lapin = liÃ¨vre (Expected: terrier)
rouge - couleur + dix = cinq (Expected: nombre)
lait - vache + miel = citron (Expected: abeille)
voiture - route + bateau = tÃ©lÃ©commandÃ© (Expected: mer)
montre - temps + boussole = superocean (Expected: direction)
lune - satellite + terre = terre! (Expected: planète)
loup - meute + poisson = maquereau (Expected: banc)
chaussette - pied + gant = chaussettes (Expected: main)
chat - miaulement + chien = aboie (Expected: aboiement)
bateau - mer + avion = hÃ©licoptÃ¨re (Expected: ciel)
saumon - poisson + cerf = chÃ¨vre (Expected: animal)
merle - oiseau + brochet = saumon (Expected: poisson)
pomme - fruit + laitue = courgette (Expected: légume)
citron - acide + lait = yaourt (Expected: doux)
soleil - chaud + neige = cieuxcouchers (Expected: froide)
froid - chauffage + chaud = chaud!! (Expected: climatisation)
rose - fleu + baobab = racine (Expected: arbre)
voiture - roue + avion = air (Expected: aile)
ananas - fruit + courgette = courgettes (Expected: légume)
